6 1 1 1 1 1 1 1 1 1 1 1 1 1 3
2 0 0 2 0 0 0 0 0 0 0 0 0 0 2
2 0 0 2 0 0 7 0 0 0 0 0 0 0 2
2 0 0 5 1 0 0 0 6 1 1 3 0 0 2
2 0 0 0 0 0 0 0 7 0 8 2 0 0 2
2 0 0 0 0 0 0 0 0 0 1 2 1 0 2
2 0 0 0 0 0 0 0 0 0 0 2 0 0 2
2 0 0 7 1 3 0 0 0 0 0 0 0 0 2
2 0 0 0 0 2 0 0 0 0 0 0 0 0 2
5 1 1 1 1 1 1 1 1 1 1 1 1 1 4
-1
0 4 8
0 2 1
0 12 3