5 5 5 5 5 5 5 5 5 5 5 5 5 5 5
5 0 0 0 0 0 0 0 0 1 0 0 0 0 5
5 0 0 0 0 0 0 1 0 0 4 4 1 0 5
5 0 0 0 0 0 0 1 3 5 3 0 2 0 5
5 0 0 0 0 0 0 0 1 3 1 0 0 1 5
5 0 0 6 0 0 0 0 0 0 0 5 1 0 6
5 0 0 0 1 1 0 0 6 0 0 0 0 0 6
5 0 5 0 0 0 6 0 1 2 0 0 7 0 6
5 0 0 0 0 1 0 0 1 1 6 0 0 0 6
5 6 6 6 6 6 6 6 6 6 6 6 6 6 6
-1
0 4 4
0 4 3
