7 7 7 7 7 7 7 7 7 7 7 7 7 7 7
7 5 0 2 5 5 5 8 5 5 5 5 5 5 7
7 1 5 4 2 5 5 5 3 5 5 5 1 2 7
7 5 5 5 5 5 5 5 5 5 6 5 5 5 7
7 5 1 5 2 5 5 5 5 3 5 6 5 5 7
7 5 3 6 3 5 0 5 4 4 3 5 5 5 7
7 5 4 4 5 5 5 5 5 6 5 5 5 5 7
7 0 5 5 5 5 5 5 0 5 5 0 1 5 7
7 5 5 1 5 5 5 0 5 5 5 5 1 5 7
7 7 7 7 7 7 7 7 7 7 7 7 7 7 7
-1
0 11 3
0 3 4
0 7 3