3 3 3 3 3 3 3 3 3 3 3 3 3 3 3
3 1 1 1 1 4 4 1 1 1 1 1 1 1 3
3 1 1 1 1 1 1 1 1 1 1 1 1 1 3
3 1 2 1 1 1 1 1 1 1 2 1 1 1 3
3 1 0 2 1 1 1 1 1 0 3 1 1 1 3
3 1 1 1 1 4 3 4 1 1 1 3 1 1 3
3 1 1 3 4 4 1 1 1 2 3 1 1 1 3
3 1 1 1 1 1 1 5 1 1 1 1 1 1 3
3 1 1 1 0 1 1 1 3 1 1 4 1 1 3
3 3 3 3 3 3 3 3 3 3 3 3 3 3 3
-1
